000000000000000
000000000000000
000000000000000
000000000000000
000000000000000
000000000000000
000000000000000
000000001111111
111110000000000
000000000000000
000000000000000
000000000000000
11111111000000
000000000000000
000000000000000