000000000000000
000000000000000
000000000011111
000000000000000
000000111100000
000000000000000
000000000000000
000000001111111
111110000000000
000000000000000
000001110000000
000000000000000
11111111000000
000000000000000
000000000000000