000000000100000
000000000100000
111111111100000
000000000111111
000000000000000
000000000000000
000000000000000
111111110000000
000000000000000
000000001111111
111110000000000
000000000000000
000001110000111
000000000000000
111111111000111